71,72,73,74,75,76,77,78,79;83,84,85,86,87,88
90,91,92,93,94,95,96,97,98,99,100,101;59,60,61,62,63,64,65,66
59,60,61,62,63,64,65,66;52,53,54,55,56
67,68,69,70,71,72,73,74,75;78,79,80,81,82,83,84,85,86,87,88,89,90,91
9,10,11;33,34,35
72,73,74,75,76,77,78,79,80,81;96,97,98,99,100,101,102
60,61,62,63,64,65,66,67,68;90,91,92,93,94,95,96,97,98,99,100,101
50,51,52,53,54,55,56,57;73,74,75,76,77,78,79,80,81,82,83,84
80,81,82,83,84;60,61,62,63,64,65,66,67,68,69
55,56,57,58,59,60,61,62,63,64,65,66,67,68,69;75,76,77,78,79,80
55,56,57,58,59,60,61,62,63,64,65,66,67;87,88,89,90,91,92,93
20,25,36,45,89;25,36,77,88,98
1,2,3,4;3,4,5,6
78,79,80,81,82,83;55,56,57,58,59,60
54,55,56,57,58;61,62,63,64,65,66,67,68,69,70,71
57,58,59,60,61,62;55,56,57,58,59,60,61,62
65,66,67,68,69,70,71,72,73,74,75,76,77,78,79;83,84,85,86,87,88,89,90,91,92,93,94,95,96,97
97,98,99,100,101;52,53,54,55,56,57,58,59,60,61,62,63,64,65,66
9,10,11;11,12,13
87,88,89,90,91,92;70,71,72,73,74,75,76,77,78,79,80